1111111111111
1C010C00000C1
1000011111001
1P0011E0C0001
1111111111111